+------------------------+
|      |       |         |
| +-+  | +--+  |  +---+  |
| | |  |    |  |      |  |
| + |  +--+ |  +---+  |  |
|   |  |    |         |  |
+---+  +  +-----------+  |
|   |     |              |
| + +-----+  +--------+  |
| |                   |  |
| +-----------------+ |  |
|  |                  |  |
|  |     +  +     +---+  |
|  +--+  |  |     |      |
|     |  |  |     |  +---+
+--+  +  |  |     +      |
|        |  |         +  |
|  +---------     +   |  |
|X |              |   |  |
+------------------------+