+-----+----+
|     |   X|
|     | +--+
| | | | +--+
+-+ +-+    |
|      + | |
| | --   | |
| |   -+-+ |
| +-+  |   |
|   +-  | -+
+-------|  |
|O         |
+-------+--+