+-----+----+
|     | +--+
S | | | +--+
+-+ +-+    |
|      + | |
| | --   | |
| |   -+-+ |
| +-+  |   |
|   +-  | -+
+------ |  |
+-------+-F+