+------+----+------+----------+
|      |    |      |         X|
| +--- | +--+ ---+ | -------+ |
| |    | |       | |        | |
| | +--+ | --+-- | +------+ | |
| | |    |   |   |        | | |
| | | +--++- | --++ +---+ | | |
| | | |   |  |    | |   | | | |
| |   | | | ++--+ | | | |   | |
| +-+ | | | | * | | | | | +-+ |
|   | | | | ++ ++ | | | | |   |
+-- | | | |  | |  | | | | | --+
|   | | | ++ | | ++ | | | |   |
| +-+ | |  | | | |  | | | | | |
| |   | +--+ | |   ++ |     | |
| | | |      | +---+  +-----+ |
| | |   +----+                |
| +-+---+    +----------------+
|O                            |
+-----------------------------+