+------+----+------+----------+
|      |    |      |          |
| +--- | +--+ ---+ | -------+ |
| |    | |       | |        | |
| | +--+ | --+-- | +------+ | |
| | |    |   |   |        | | |
| | | +--++- | --++ +---+ | | |
| | | |   |  |    | |   | | | |
| |   | | | ++--+ | | | |   | |
| +-+ | | | | * | | | | | +-+ |
|   | | | | ++ ++ | | | | |   |
+-- | | | |  | |  | | | | | --+
|   | | | ++ | | ++ | | | |   |
| +-+ | |  | | | |  | | | | | |
| |   | +--+ | | | ++ | |   | |
| | | |      | +-+-+  +-+---+ |
| | |   +----+                |
| +-+---+    +----------------+
|                             |
+------------- ---------------+